111111111111111111111111111111111111
1 111  E11       111  M   1111     1
1   1   111111   1  111  11        1
1 111 11    D    1    11    1111 111
1 1    1 1     D 1  1 111111111  1 1
1      1 11111   1  1 1          1 1
1 1    1     1   1 11 11   1111111 1
1 111111     1 111 1   1        11 1
1            1     1   1   1111 1  1
11 1111      1111  11      11    1 1
1  11 111111  1   D    111 1       1
1   1    1    1111       1 1       1
1 11111  1    1      11    1 111   1
1     11 1    1 D  1111111 11  11  1
1  M   1   1111111     111     D  P1
111111111111111111111111111111111111