111111111111111111111111111111111111
1P 1111111       111 M    1111 M   1
1   1   111111   1  111  11        1
1 111111         1   111    1111 111
1 1      1       1    111111111  1 1
1 1    1 11111   1    1          1 1
1 1    1     1   1    11   1111111 1
1 111111     1 111     1        11 1
1            1         1  M1111 1  1
11 1111      1111  1111111111    1 1
1  11    D    1          111       1
1   1         1111  D    111       1
1 11111       1      11111111111   1
1     11      1    1111111111      1
1      1   1111111                E1
111111111111111111111111111111111111