111111111111111111111111111111111111
1      111M      111      1111    E1
1   1   111111   1   11  11        1
1 111 11         1   111    1111 111
1M1      1       1    11     11  1 1
1 1    1 11111   1  D 1          1 1
1 1    1     1   1    11   1111111 1
1 111111     1 111     1        11 1
1            1         1 M 11111   1
11 1111  111   11  1111111111    1 1
1  11      1  1          111       1
1   1   D  1  1111       111       1
1 111 1    1  1      111    1111   1
1   D 11   1       111111 111      1
1P     1   1111111                 1
111111111111111111111111111111111111